changestatus	changestatus	prefix	3
updatecommands	updatecommands	prefix	3
goodnight	goodnight	prefix	3
sendmessage	sendmessage	prefix	3
updatesettings	updatesettings	prefix	3
updatesetting	updatesetting	prefix	3
addsetting	addsetting	prefix	3
addresponse	addresponse	prefix	3
removeresponse	removeresponse	prefix	3
purge	purge	prefix	2
restrict	restrictuser	prefix	2
unrestrict	unrestrictuser	prefix	2
bugreport	bugreport	prefix	1
oops	oops	prefix	1
command	commands	prefix	1
commands	commands	prefix	1
help	help_cmd	prefix	1
invite	invite	prefix	1
roll	roll	prefix	1
r	roll	prefix	1
repeatroll	repeatroll	prefix	1
repeatr	repeatroll	prefix	1
rr	repeatroll	prefix	1
rroll	repeatroll	prefix	1
chip	chip	prefix	1
chips	chip	prefix	1
power	power	prefix	1
powers	power	prefix	1
ncp	ncp	prefix	1
virus	virus	prefix	1
virusx	virusx	prefix	1
tag	tag	prefix	1
query	query	prefix	1
bond	bond	prefix	1
bondpower	bond	prefix	1
bondpowers	bond	prefix	1
mysterydata	mysterydata	prefix	1
md	mysterydata	prefix	1
mysteryreward	mysteryreward	prefix	1
rulebook	rulebook	prefix	1
element	element	prefix	1
daemon	daemon	prefix	1
upgrade	upgrade	prefix	1
npu	upgrade	prefix	1
crimsonnoise	crimsonnoise	prefix	1
mod	networkmod	prefix	1
networkmod	networkmod	prefix	1
audience	audience	prefix	1
cheer	cheer	prefix	1
jeer	jeer	prefix	1
virusr	virusr	prefix	1
virusrandom	virusr	prefix	1
changeprefix	change_prefix	prefix	4
repo	repo	prefix	1
pmr	repo	prefix	1
playermade	repo	prefix	1
pmc	repo	prefix	1
adventure	adventure	prefix	1
fight	fight	prefix	1
sheet	sheet	prefix	1
spotlight	spotlight	prefix	1
spotlightchecklist	spotlight	prefix	1
checklist	spotlight	prefix	1
weather	weather	prefix	1
cyberweather	weather	prefix	1
achievement	achievement	prefix	1
achievements	achievement	prefix	1
achieve	achievement	prefix	1
